 ##P###D##P##
#.R..E...S..E#
#..S..R.B...B#
#...R..K.E..B#
#.S...S..R..E#
#.R..B..B...B#
 #P####D#P###