C##P######P##C
#.R..E...S..E#
#..S..R.B...B#
#...R..K.E..B#
#.S...S..R..E#
#.R..B..B...B#
C#P####D#P###C