 ##P###D##P##
#.R..B..B.S.B#
#.S..S..S.S.B#
#.R..E.K.S..E#
#.RS.B..B...B#
 #P#D##D#P###