 ##PD##D##P##
#SS..E...S.SS#
#SR..B...S..S#
#SR..R.K.S..S#
#SR..E..B.E.S#
#SSR....S.RSS#
 #P#D##D#P###